Count	A	C	G	N	T	LenSeq	Name
2911	72915	45834	43995	1	70135	232880	All
102	2677	1460	1527	0	2496	8160	chr10
158	4213	2256	2539	0	3632	12640	chr11
123	3026	1875	1832	0	3107	9840	chr12
48	1252	681	730	0	1177	3840	chr13
66	1575	1012	930	0	1763	5280	chr14
72	1822	997	1132	0	1809	5760	chr15
41	972	644	643	0	1021	3280	chr16
85	1959	1370	1410	0	2061	6800	chr17
60	1455	907	885	0	1553	4800	chr18
19	478	331	293	0	418	1520	chr19
200	4987	3119	2959	0	4935	16000	chr1
1	15	14	17	0	34	80	chr1_gl000191_random
31	707	508	447	0	818	2480	chr20
16	410	222	235	0	413	1280	chr21
21	525	276	352	0	527	1680	chr22
196	4997	2976	2857	0	4850	15680	chr2
147	3581	2150	2231	0	3798	11760	chr3
103	2543	1496	1553	0	2648	8240	chr4
125	3070	1928	1775	0	3227	10000	chr5
129	3303	1936	1969	0	3112	10320	chr6
114	2815	1716	1701	0	2888	9120	chr7
86	2296	1248	1309	0	2027	6880	chr8
77	1887	1237	1111	0	1925	6160	chr9
304	8708	6169	3889	0	5554	24320	chrM
1	18	19	17	0	26	80	chrUn_gl000212
6	144	103	128	0	105	480	chrUn_gl000220
59	1487	868	916	0	1449	4720	chrX
8	170	128	129	0	213	640	chrY
513	11823	8188	8479	1	12549	41040	Unkown
